\n = \n
"Daniel" = "丹尼爾"
"Dedication" = "僅獻給妳"
"Getting Lonnie" = "我不懂「妮」"
"I Can Sing" = "我能唱歌"
"I Said Yes" = "我願意"
"It's Different Now" = "不同以往"
"Life Moves On" = "總是要過生活"
"Ship Date" = "奔走他鄉"
"The Nunnery" = "剃度成尼"
"Dealing With Roots" = "三千煩惱絲"
"Stick With The Group" = "別落單"
"A Very Long Phase" = "好一段過程"
"Just Gone" = "不著痕跡"
(Custom) = (Custom)
? = ?
\nHey Sam,\n\nI'm writing to you from Multnomah Falls! I'm here on a stupid class trip which is stupid because it's March and I don't know if anyone running this school has been to Oregon but it's cold and rainy as shit in March!\n\nWish you were here! OH WAIT YOU ARE HERE because I'm writing this to you in the gift shop oh shit here you come\n\n-L = \n嘿，小珊\n\n我在貓挪馬瀑布寫信給妳呢! 我現在在蠢到爆的班遊，現在才三月！我是不知道這些校董有沒有在三月份來過奧瑞崗州，三月的這裡真的只有冷和他媽狂下雨而已！\n\n好希望妳在這裡！其實妳在這裡啦，妳正在我寫明信片的紀念品店！拿去唄～\n\n-小蘭
"Adjusting to the Dark" = "黑暗裡的美好事物"
"At the New House" = "新居落成"
"Best-Laid Plans" = "錦囊妙計"
"Default Friends" = "基本盤朋友"
"Big Gold Star" = "非認識妳不可"
"Hanging Out With Girls" = "姐妹淘出遊"
"First Day of School" = "新生到課"
"Lie-to-Mom-and-Dad Situation" = "欺瞞父母的狀況"
"There Was Nothing Wrong" = "這沒有什麼嘛"
101.9 KINK FM Presents\n\nEarth, Wind & Fire\n\nKeller Auditorium\n\nThu Feb 23, 1995 8:00 PM = 101.9 KINK FM 為您獻上\n\n「地，風與火」樂團\n\n凱勒演奏廳\n\n1995年二月23日星期四晚上八點
1024x768 = 1024x768
1280x720 = 1280x720
1600x1200 = 1600x1200
1600x900 = 1600x900
1920x1080 = 1920x1080
60 = 60
65 = 65
70 = 70
75 = 75
80 = 80
85 = 85
90 = 90
A hand-drawn little map that looks like it leads to somewhere in the house... = 這張手繪地圖好像房子裡的某個部分...
A letter from Granddad = 祖父的來信
A spare key that was hidden under ol' Christmas Duck. = 聖誕鴨下面藏的鑰匙
A Stranger Under My Roof\nUnderstanding Teens = 屋簷下的陌生人\n了解青少年
Accept = 接受
Active Modifiers:\n = Active Modifiers:\n
added to backpack = 放入背包
Adjust Brightness = 調整亮度
Adjust Field of View = 調整視角
-Advanced Options- = -進階選項-
Adventurous the Cat Returns = 冒險小貓凱旋歸來
After the Honeymoon\n\nRediscovering Your Spouse: Personally, Spiritually, Sexually = 蜜月之後\n\n重新發現你的伴侶：人格，性靈，與性慾
All Doors Unlocked\n = 所有門都打開\n
ALL LIGHTS START ON - For those who\ndon't like the dark. = 大燈全開 - 給那些\n怕黑的人
All Lights Start On\n = 所有燈打開\n
Ambient Occlusion = 環境遮蔽
Anisotropic Filtering = 抗鋸齒與非等方性過濾
Another one of the postcards I sent! = 另一張我寄回來的明信片！
AntiAliasing = 反鋸齒
Applying changes... = 套用變更...
Apr. 10, 1995 = 1995年4月10日
Apr. 5, 1995 = 1995年4月5日
Apr. 22, 1995 = 1995年4月22日
Attic key = 閣樓鑰匙
Audio Diaries Disabled\n = 關閉語音日記\n
Aug. 20, 1994 = 1994年8月20日
Oct. 3, 1994 = 1994年10月3日
Awww, Mitten = 噢, 米頓
Back = 返回
Back to basics:\nSent back in time to Dallas 1963 again? = 回歸當初:\n讓我們再次回到1963年的達拉斯好嗎？
Basement key = 地下室鑰匙
Bloom = 高光
Boarding pass = 登機證
Bratmobile = Bratmobile
Bratmobile\n\nCool Schmool = Bratmobile\n\nCool Schmool
Bratmobile\n\nPottymouth = Bratmobile\n\nPottymouth
Bratmobile\n\nSome Special = Bratmobile\n\nSome Special
Bratmobile\n\nThe Revue 3/26 = Bratmobile\n\nThe Revue 3/26
CALL DANIEL BACK!! = 回電給丹尼爾！
Cancel = 取消
Captain A.\n\nRev-L-Ution Grrrl = 愛兒船長\n\n女性革命
Captain Allegra\nand\nthe First Mate\n\n\n\n\nYour Costume\n\nMy Costume\n-L = 愛兒葛拉船長\n和\n大副\n\n\n\n\n你的套裝\n\n我的套裝\n-小蘭
CAUTION\nRADIATION AREA\nKEEP OUT = CAUTION\nRADIATION AREA\nKEEP OUT
Chinese?\nJapanese\nLebanese? = 中國人?\n日本人\n黎巴嫩人?
Close armoire = 關上衣櫥
Close cabinet = 關上櫃子
Close cover = 闔上蓋子
Close dishwasher = 關閉洗碗機
Close dishwasher rack = 放回碗盤架
Close door = 關門
Close drawer = 關上抽屜
Close dryer = 闔上烘乾機門
Close folder = 闔上資料夾
Close fridge = 闔上冰箱
Close hamper = 闔上食物籃
Close lid = Close lid
Close locker = 闔上置物櫃
Close microwave = 闔上微波爐
Close panel = 關上暗門
Close pizza box = 闔上披薩盒
Close safe = 關閉保險箱
Close sliding door = 拉上滑門
Close trunk = 闔上箱子
Close washer = 闔上洗衣機蓋
Completed combination to Sam's locker = 解開小珊置物櫃的密碼鎖
Configure Controls = 控制設定
Control = 控制
Controls = 控制
Crouch = 蹲下
Crouch Style: = 蹲下方式：
Crown Burger: Sam = 皇冠漢堡：小珊
Current Language: = 現在語言：
Dad's\nOffice = 爸爸的辦公室
DANGER\n\nWear goggles and rubber gloves when handling anything in this room = 危險\n\n欲動房內物品請佩戴夜視鏡及絕緣手套
Daniel Called = 丹尼爾來電
Daniel called again. He wants his Ninetendo game back. = 丹尼爾又打來了。他要拿回他的任天堂。
Daniel says he's coming over to get his game back = 丹尼爾說他要來拿他的遊戲。
Darkroom = Darkroom
Dear Mom, Dad, and Sam,\n\nI am in the CHUNNEL! This is my second passage through the CHUNNEL! I'm on my way back from London, this time going to Brussels, Belgium. Sorry I didn't write you on the way to London but I was too excited about the CHUNNEL!!\n\nLondon was great. Dad, I know you've always wanted to visit and I think you really should. You'd love it! If you all wanted to come back here as a family sometime I GUESS I could be convinced.\n\nLove you all!\n\nKatie = 親愛的爸，媽，小珊：\n\n我在英吉利海峽海底隧道！這是第二次經過了！我現在要回倫敦，然後去比利時的布魯塞爾。抱歉去倫敦的路上沒寫信給你們，因為我太期待海底隧道了！！\n\n倫敦很棒，老爸，我知道早就想來這兒了，你一定要來看看。如果家庭旅遊要來倫敦晃晃，我會考慮一下的。\n\n我愛你們！！\n\n凱蒂
Dec. 8, 1994 = 1994年12月8日
Definitely not reading any more of that. = 再也不要看那些東西了。
Detect = 自動偵測
Dining\nRoom = 餐廳
Disable Interaction Highlight = 關閉可互動物品提示
Disable Interaction Text = 關閉文字互動提示
DISABLE MAP - There will be no in-game map\nto guide you. = 關閉地圖 - 遊戲內將沒有地圖\n引導你。
DISABLE VOICE DIARIES - Checking this disables\nSam's voiceover. No ending prompt will appear.\nIt will be up to you when to stop playing. = DISABLE VOICE DIARIES - Checking this disables\nSam's voiceover. No ending prompt will appear.\nIt will be up to you when to stop playing.
Display Subtitles = 顯示字幕
Down a Floor = 往下一層
DUNK! = DUNK!
Early spaceflight: utopia\nAdvance techonlogy, end WWII early, time stream too different? = 航天競賽: 烏托邦\n先進科技, 二戰初期結束, 時序錯綜複雜?
Eject tape = 退出錄音帶
En Espanol = 圖解西語
Enable Headbob = 開啓步行模擬
Enter combination = 輸入密碼
Escape from Ghost Mansion = 逃離鬼宅
Examine book = 檢查書籍
Examine bookmark = 檢查書籤
Examine bottle = 檢查瓶子
Examine business card = 檢查名片
Examine comic book = 檢查漫畫書
Examine composition book = 檢查筆記本
Examine drawing = 檢查塗鴉
Examine form = 檢查表格
Examine magazine = 檢查雜誌
Examine map = 檢查地圖
Examine newspaper clipping = 檢查報紙殘頁
Examine note = 檢查筆記
Examine page = 檢查殘頁
Examine pamphlet = 檢查手冊
Examine paper = 檢查紙本
Examine paper scrap = 檢查紙片
Examine photo = 檢查相片
Examine scrap = 檢查紙片
Examine show flyer = 檢查表演傳單
Examine slip = 檢查字條
Examine stub = 檢查存根
Examine ticket = 檢查票根
Examine zine = 檢查雜誌
Exit = 離開
Fastest = 最低階
Feb. 11, 1995 = 1995年2月11日
Flick bell = Flick bell
Flip light switch = Flip light switch
Flush toilet = 沖馬桶
FOR GOD SO LOVED THE WORLD\nHE GAVE HIS ONLY SON = 約翰福音第3張第16節\n神愛世人\n所以賜下獨生子耶穌
Foyer = 前廳
Frob Me Delicately = Frob Me Delicately
From the Desk of Richard Greenbriar Ph.D.\n\nDear Terrence,\nThank you for sending along a copy of your newly published book. An author's first published manuscript is a momentous occasion. I read it this afternoon. I certainly recognized my son in the subject matter. An author's work is the externalization of that which he holds dear (and that which he fears,) and in this respect I believe your work was successful. But the lens through which the personal shone was needlessly clouded by genre cliches and implausible dimestore science fictional dei ex machina. I congratulate you on the surviving the great ordeal that is publication, and rest assured that readers of your chosen genre will lap up copies hungrily. But I urge you to shed artifice.\n\nYou can do better.\n\nWith a father's love and encouragement,\nRichard Greenbriar Ph.D. = 理查・葛林布萊爾博士案前所筆\n\n親愛的泰倫斯，\n謝謝你寄給我你的新書，新手作家的第一部作品總是值得紀念。今天下午讀完它之後，想當然耳，我在故事中看到了你的影子。一位作家的作品是他所珍惜（或是懼怕）的事物的外化，從這個觀點來看你的作品很成功，但是故事的主體性卻被一些陳腔濫調的元素給遮蔽了。 還是得恭喜你在出版的考驗中活了下來，我敢肯定喜好這類作品的讀者會蜂湧而至。希冀你能每況愈上。\n\n你可以做得更好。\n\n來自父親的愛與鼓勵，\n理查・葛林布萊爾博士
Front Porch = 門廊
Full screen = 全螢幕
Gameplay = 遊戲內容
Garage = 車庫
Girlscout\n\nSelf = Girlscout\n\nSelf
Girlscout\n\Role Model = Girlscout\n\Role Model
Good ol' Christmas Duck. = 好樣的聖誕鴨鴨
Goodfellow High School = 古德斐洛中學
Gosh, dad. = 天啊，老爸！
Gosh, Sam. = 天啊！小珊！
Got Your Number! = 拿到你的電話囉!
Grab 3-ring binder = 拿起三孔活頁夾
Grab apple = 拿起蘋果
Grab bag = 拿起袋子
Grab banana = 拿起香蕉
Grab bell = 拿起鈴鐺
Grab boardgame = 拿起桌遊
Grab book = 拿起書本
Grab bottle = 拿起瓶子
Grab bowl = 拿起碗
Grab box = 拿起盒子
Grab broom = 拿起掃把
Grab brush = 拿起牙刷
Grab bunch of coupons = 拿起折價券
Grab button = 拿起胸針
Grab can = 拿起罐頭
Grab candle = 拿起蠟燭
Grab cartridge = 拿起遊戲卡帶
Grab cassette = 拿起錄音帶
Grab chalk = 拿起粉筆
Grab cheese = 拿起起司
Grab chips = 拿起洋芋片
Grab Christmas Duck = 拿起聖誕鴨
Grab cigarette pack = 拿起菸盒
Grab cleansing powder = 拿起清潔粉
Grab coaster = Grab coaster
Grab collar = 拿起項圈
Grab comb = 拿起梳子
Grab cookie jar lid = 拿起餅乾罐蓋子
Grab couch pillow = 拿起抱枕
Grab crucifix = 拿起十字架
Grab cup = 拿起杯子
Grab cutting board = 拿起粘版
Grab Dad's second book = 拿起爸爸的第二本書
Grab detergent = 拿起清潔劑
Grab die = Grab die
Grab dustpan = 拿起畚箕
Grab emery board = 拿起指甲銼刀
Grab eraser = 拿起橡皮擦
Grab fork = 拿起叉子
Grab glass = 拿起玻璃杯
Grab hairbrush = 拿起毛刷
Grab handsoap = 拿起洗手乳
Grab hat = 拿起帽子
Grab highlighter = 拿起螢光筆
Grab ice cream = 拿起冰淇淋
Grab jam = 拿起果醬
Grab ketchup = 拿起番茄醬
Grab knife = 拿起刀子
Grab label = 拿起標簽
Grab lid = 拿起蓋子
Grab lip balm = 拿起護唇膏
Grab loose panel = 拿起鬆掉的隔板
Grab manuscript = 拿起原稿
Grab marker = 拿起麥克筆
Grab matchbook = 拿起火柴盒
Grab milk = 拿起牛奶
Grab mom's purse = 拿起媽的皮包
Grab mug = 拿起馬克杯
Grab nail polish = 拿起指甲油
Grab nametag = 拿起名牌
Grab pack of cards = 拿起一盒撲克牌
Grab paint can = 拿起油漆桶
Grab peanut butter = 拿起花生醬
Grab pen = 拿起筆
Grab pencil = 拿起鉛筆
Grab phone = 拿起電話
Grab photo = 拿起相片
Grab photo paper = 拿起相紙
Grab pillow = 拿起枕頭
Grab plaque = 拿起紀念牌
Grab plate = 拿起盤子
Grab poltergeist book = 拿起靈異小說
Grab postcard = 拿起明信片
Grab pot = 拿起鍋子
Grab relish = 拿起佐料
Grab salad dressing = 拿起沙拉醬
Grab scrap = 拿起紙片
Grab shampoo = 拿起洗髮乳
Grab shaving cream = 拿起刮鬍泡
Grab shot glass = 拿起烈酒杯
Grab skull = 拿起骷髏
Grab soda can = 拿起汽水罐
Grab softener = 拿起柔軟精
Grab spoon = 拿起湯匙
Grab syringe = 拿起針筒
Grab tampon = 拿起衛生棉條
Grab textbook = 拿起教科書
Grab throw pillow = 拿起抱枕
Grab tissue box = 拿起衛生紙盒
Grab toilet paper = 拿起廁紙
Grab toilet paper roll = 拿起廁紙卷
Grab toothbrush = 拿起牙刷
Grab toothpaste = 拿起牙膏
Grab toy = 拿起玩具
Grab uncrumpled manuscript = 拿起揉過又攤平的原稿
Grab veggies = 拿起蔬菜
Grab... Steggy? Stelly? = 拿起... 史戴基? 史泰利?
Graphics = 畫面
Graphics Quality: = 畫質：
Grassy knoll steamrolled? = 碧草丘\n無可避免?
Green\nHouse = 溫室
GRRRL JUSTICE NOW = GRRRL JUSTICE NOW
GRRRL JUSTICE NOW\n\nKicking Against the Patriarchy\n\nThe Great Goodfellow Riot of '95\n\nIssue #1!! = 女性當道雜誌\n\n討伐父權主義\n\n1995年古德斐洛大暴動\n\n第一期！！
Guardian Angels Up Above\nBless This House With Lots of Love = 守護天使在上\n以愛保護這個家
Guess this one's broken. = 我猜這壞掉了
Guest Room = 客房
HAD ENOUGH?! = 受夠了嗎？！
Half of Sam's locker combo = 半片小珊置物櫃的密碼
Hand-drawn map = 手繪地圖
Hauntings & Poltergeists = 鬼影追追追
Healthy Choices\n\nSkills for a Healthful Life = 健康新主張\n\n讓妳健康樂活的技巧
HEARD ENOUGH? = 聽夠了沒？！
Heavens to Betsy = Heavens to Betsy
Heavens to Betsy\n\nBratmobile\n\nGirls to the Front! = Heavens to Betsy\n\nBratmobile\n\nGirls to the Front!
Heavens to Betsy\n\nCalculated = Heavens to Betsy\n\nCalculated
Heavens to Betsy\n\nNothing Can Stop Me = Heavens to Betsy\n\nNothing Can Stop Me
Heavens to Betsy\n\nTerrorist = Heavens to Betsy\n\nTerrorist
Hey, it's one of the postcards I sent = 嘿！這是我寄回來的明信片
Hi Mom, Dad, & Sam,\n\nI have had a wonderful time on the beaches of Barcelona. Dad & Sam, I think you would like the Gaudi architecture. It is from a strange alien world.\n\nI am headed to my final destination, Amsterdam. For how long? That depends! I am running low on money. I will look for a cheap standby ticket and call you when I'm headed home. Sorry for the short notice! Can't wait to see you all again! It'll be good to be home...\n\nLove, Katie = 媽，爸，和小珊：\n\n我在巴賽隆那的海邊度過了美好的時光。爸，小珊，我想你們會喜歡高地的建築，它們活像詭異的外星生物一樣。\n\n我即將前往歐洲之旅的最終站，阿姆斯特丹。至於要待多久？看情況囉！我快要沒錢了，我會找個便宜的地方下榻，到家再打電話給你們。抱歉無法再寫了！等不及見面囉！返家的感覺一定不錯！！\n\n愛你們，凱蒂
Hi Mom, Dad, and Sam,\n\nThe Vatican is weird! As you can see, the Catholic Church still has a lot of money left over from the Middle Ages. I've gotten to see all of the art, including the Sistine Chapel ceiling and sculptures by Michaelangelo, Donatello, and the rest of the Ninja Turtles. Mom, we'll have to come back together. I would love to be here with someone who really appreciates the history behind everything. Also, Sam, they have various Relics, as in pieces of important dead people, so you should come too.\n\nNext stop: Barcelona! Calm down, Dad, I won't get gored by a bull. Probably.\n\nLove, Katie = 媽，爸，和小珊：\n\n梵蒂岡超怪的，如你所見，中世紀過後教廷仍然坐擁金山，我一定要拜訪所有景點，西斯汀禮拜堂的屋頂繪畫還有米開朗基羅的雕塑品，還有忍者龜！媽，我們一定要一起來一次，我想和一為深諳此地一景一物背後歷史的人同遊。還有，小珊，這裡也有很多古墓遺跡，妳應該來看看的。\n\n下一站：巴賽隆那！別緊張，老爸，我不會被公牛角刺穿的，應該吧，哈哈\n\n愛你們，凱蒂
Hi Mom, Dad, and Sam,\nI'm in Paris! I have done many Parisian things, including eating le petit dejeuner and wearing a beret. I'm going to have lots of film to develop when I get back!! Sam, I'm bringing you back something from the Shakespeare Book Company, since you are my favorite sister.\n\nLove you all!\nKatie = 嗨，爸、媽還有小珊,\n我在巴黎呢！我做了好多巴黎人的事情！包括吃法式早餐還有戴貝雷帽。我到家的時候會有一堆負片等著我沖。我最愛的妹妹小珊，我會帶一些莎士比亞出版社的書給你！\n\n愛你們喲！\n凱蒂
Hidden compartments marked on map. Press <Map> to review. = 隱藏暗門已標示在地圖上，按 <Map> 檢視
Hide Reticule = 隱藏中心輔助點
High = 高
Hold = 按住
Hold <Zoom> to look closer = 按住 <Zoom> 看得更仔細點
Housekey = 家門鑰匙
I sent this one from Barcelona = 我從巴賽隆那寄回來的
I think that's mom's citizenship stuff = 我想這是媽媽的公民證之類的
I Want To Believe = 我想相信
I... no. = 我⋯⋯算了吧
Insert tape = 放入卡帶
Interact = Interact
Intercept LHO in USSR? ???\nLHO: Killed in Marines? = 在蘇聯阻止哈維？？？\n李・哈維・奧斯洛在海陸服役被殺？
Invert Look = 反轉視角
Invert Mouse Y = 反轉滑鼠 Y 軸
Items = 物品
It's Mom's old work mug = 這是老媽工作用的馬克杯
It's my passport. I got it to go on my Europe trip. = 我的護照。我用它來周遊歐洲。
It's Steggy. = 這是史戴基
It's that book Dad wrote = 這是老爸寫的小說
Jan. 12, 1995 = 1995年1月12日
JFK President: US + USSR = Coalition? = 甘迺迪→美國＋蘇聯＝合作關係？
JFK:\nPoisoned\nkidnapped\nInjured = 甘迺迪：\n下毒\n綁架\n受傷
Journals = 手札
Joyce\n\nA Complete Understanding\n\nRichard Greenbriar, Ph.D.\n\nUniversity of Oregon Press = 喬伊斯\n\n求知的歷程\n\n理查・葛林布萊爾博士\n\n奧瑞岡大學出版
Jun. 3, 1995 = 1995年6月3日
Jun. 5, 1995 = 1995年6月5日
Jun. 6, 1995 = 1995年6月6 日
June 1995\n\nKatie comes home this month! (Will call with exact date)\n\nJune 3-7: Anniversary Trip = June 1995\n\nKatie comes home this month! (Will call with exact date)\n\nJune 3-7: Anniversary Trip
Junk\nRoom = Junk\nRoom
K is for Kind\nA is for Amazing\nI is for Intelligent\nT is for Talented\nL is for Light-Hearted\nI is for Important\nN is for Nice = K就是親切（Kind）\nA就是驚奇（Amazing）\nI就是智慧（Intelligent）\nT就是天賦（ Talented）\nL就是無憂（Light-Hearted）\nI就是重要（Important）\nN就是好相處（Nice）
Kaitlin Greenbriar\nPortland\nFlight 270\nJune 6, 1995 = 凱特琳・葛林布萊爾\n波特蘭\n航班 270\n1995年6月6日
Katie,\nI'm sorry I can't be there to see you, but it is impossible. Please, please don't go digging around trying to find out where I am. I don't want anyone to know.\nWe'll see each other again someday. Don't be worried. I love you.\n-Sam = 凱蒂,\n抱歉我無法迎接妳歸來，我無法。拜託，拜託妳不要試著找到我在哪裡，我不想要任何人知道。\n某天我們會再見面的。別擔心，我愛你。\n-小珊
KICKING AGAINST THE PATRIARCHY = 踢爆父權體制
Kitchen = 廚房
KSNC Presents\n\nSonic Boom '94\n\n\nMay 7, Takelma Fairgrounds = KSNC Presents\n\nSonic Boom '94\n\n\nMay 7, Takelma Fairgrounds
Language = 語系
Language Options = 語系選項
Laundry = 洗衣間
LB = LB
Legend of Crystal = 水晶傳說
Library = 圖書室
Locked = Locked
Locked. = Locked.
Look closer: <Zoom>      Crouch: <Crouch>\nCheck items: <ShowInventory>      Check map: <Map>      Review journals: <Journal> = 近看：<Zoom>      蹲下：<Crouch>\n檢查物品：<ShowInventory>      檢視地圖：<Map>      翻閱手札：<Journal>
Look closer: <Zoom>      Crouch: <Crouch>\nCheck items: <ToggleInventory>      Check map: <Map>      Review journals: <Journal> = 近看：<Zoom>      蹲下：<Crouch>\n檢查物品：<ToggleInventory>      檢視地圖：<Map>      翻閱手札：<Journal>
Look sensitivity = Look sensitivity
Low = 低
Main Volume = 主音量
Making Friends Even When You're Shy\n\nSam- Thought this might help. -Dad = 再害羞也要交朋友\n\n小珊- 這本書應該會幫你不少 - 老爸
Man, Sam had this in like 4th grade = 天啊，這不是小珊四年級在用的嗎
Manual for Forestry Research and Education\n\nTakelma County Forest Service = 林務研究與教育手冊\n\n塔克馬郡林務局
Map = 地圖
Map Disabled\n = Map Disabled\n
Map updated with location of secret door. Press <Map> to review. = 地圖已更新暗門位置，按 <Map> 檢視.
Mar. 11, 1994 = 1994年3月11日
Masan's Pharmacy\nJan.-June 1960 = 梅森藥局\n1960年上半年度
Max = Max
May 1, 1995 = 1995年5月1日
May 19, 1995 = 1995年5月19日
Medium = 中
Millais\n\n\nPacific Institute of Art Exhibition\n\nAugust 19-November 30, 1991 = Millais\n\n\nPacific Institute of Art Exhibition\n\nAugust 19-November 30, 1991
Mitten = 米頓
Mitten\n\n1818 Dry Creek Rd. = 米頓\n\n旱溪路1818號
Modifiers = 修改器
Mom & Dad's\nBedroom = 爸媽的\房間
Motion Blur = 動態模糊
Mouse Acceleration = 滑鼠速度
Mouse Sensitivity = 滑鼠敏感度
Mouse Smoothing = 滑鼠平滑度
Move loose board = Move loose board
Move the mouse to rotate what you're examining. = 移動滑鼠來旋轉物品。
Move the thumbsticks to rotate what you're examining. = 移動類比搖桿來旋轉物品。
Music Volume = 音樂音量
Music\nRoom = 音樂房
My passport = 我的護照
My trusty Walkman. A constant companion on my travels. = My trusty Walkman. A constant companion on my travels.
My Walkman = 我的隨身聽
New Game = 新遊戲
No = 否
Nope! = 才不呢!
Not gonna happen. = 才沒有機會呢。
Nov. 1, 1994 = 1994年11月1日
Oct. 2, 1994 = 1994年10月2日
Oct. 22, 1994 = 1994年10月22日
Oct. 29, 1994 = 1994年10月29日
Off = 關閉
Oh man, one of my old sex ed assignments = 天啊，我的性教育作業
Oh, barf. = 嗯, 好樣的.
Oh, look. A ghost game. = 好的，靈異遊戲嘛
Oh, this is one of Granddad's books = 噢，這是祖父的書
Oh. It doesn't work. = 好像不太能用
Okay, not reading any more of that. = 好的，我看不下去了
One of dad's books, with something stuck to it? = 爸爸寫的書，好像有東西夾在裡面
Open = 打開
Open armoire = 打開衣櫥
Open attic = 打開閣樓
Open cabinet = 打開儲藏櫃
Open cover = 打開蓋子
Open dishwasher = 打開洗碗機門
Open dishwasher rack = 拉出碗盤架
Open door = 打開門
Open drawer = 打開抽屜
Open Drawer = 打開抽屜
Open dryer = 打開烘乾機門
Open folder = 打開資料夾
Open freezer = 打開冷藏櫃
Open fridge = 打開冰箱
Open hamper = 打開食物籃
Open lid = 打開上蓋
Open microwave = 打開微波爐
Open oven = 打開微波爐
Open panel = 打開夾層
Open pizza box = 打開披薩盒
Open safe = 打開保險箱
Open sewing table = 打開裁縫桌
Open sliding door = 打開滑門
Open trunk = 打開箱子
Open warmer drawer = 開啟加熱器抽屜
Open washer = 打開洗衣機蓋
Options = 設定
Order this month:\n2 cases brandy\n2 cases rum\n1 barrel whisky\nGovernor remains very pleased with enforcement in Boon County. Believe this arrangement shall hold for some time.\n\nW.R.\nMar. '23 = 本月訂購：\n２箱白蘭地\n２箱蘭姆酒\n１桶威士忌\n州長對於布恩郡的執行情形非常滿意，相信這樣的安排可以平靜好一陣子。\n\nW.R.\n3月23日
OSCAR\nMasan's Pharmacy = 奧斯卡\n梅森藥局
Over the Alps = 飛越阿爾卑斯
Overlay Text = 覆蓋文字
Paradox results in JFK death being DESIRED OUTCOME?? = 讀者希望看到與甘迺迪死亡的矛盾點？？
Pick up cassette case = 拿起錄音帶
Pick up family photo = 拿起全家福照
Pick up my old Track trophy = 拿起我之前的田賽獎杯
Pick up one of my trophies = 拾起我的一座獎杯
Pick up Ouija board = 拿起碟仙盤
Play messages = 播放留言
Play record = 播放唱片
Possession and Exorcism\n\n\n\nInteracting with the Supernatural and Releasing Unwanted Spirits = 著魔與驅魔儀式\n\n\n\n與超自然現象及不該被釋放的鬼神互動
Press [658be1]X[-]\nto toggle text = Press [658be1]X[-]\nto toggle text
Press <Crouch> to crouch. = 按 <Crouch> 蹲下。
Press <Map> to check your location in the house. = 按 <Map> 檢視房內的地圖。
Press <ShowInventory> to check the contents of your backpack. = 按 <ShowInventory> 檢視背包內的物品。
Press <StopJournal> to stop listening. = 按 <StopJournal> 停止播放。
Press <ToggleInventory> to check the contents of your backpack. = 按 <ToggleInventory> 檢視背包內的物品。
Press <Zoom> to examine a held object. = 按 <Zoom> 來檢查手上的物品。
Press > to re-listen to journals. = 按 > 重播手札。
Press button = 按按鈕
Press water dispenser = 按飲水機
Primary = 主要
PrimaryFont = PrimaryFont
Pull chain = 拉鏈繩
Pull handle = 拉拉柄
Pull string = 拉拉繩
Put back = 放回去
Quit to desktop? = 返回桌面？
RB = RB
Read "Letters to Katie" = 閱讀 "給凱蒂的信"
Read assignment = 閱讀作業
Read brochure = 讀小手冊
Read card = 讀卡片
Read chapter = 閱讀章節片段
Read clipping = 閱讀簡章
Read codes = 閱讀招式表
Read crumpled note = 閱讀揉掉的紙團
Read crumpled pages = 閱讀揉掉的紙團
Read crumpled paper = 閱讀揉掉的紙團
Read document = 閱讀文件
Read invitation = 閱讀邀請函
Read invoice = 閱讀收據
Read itinerary = 閱讀旅遊札記
Read letter = 閱讀信件
Read newspaper clipping = 閱讀剪報
Read note = 閱讀筆記
Read notes = 閱讀筆記
Read obituary = 閱讀訃文
Read page = 閱讀文件
Read pages = 閱讀文件
Read personal calendar = 閱讀個人行事曆
Read shipping label = 閱讀送達明細
Read slip = 閱讀字條
Read sternly-worded letter = 閱讀筆鋒尖銳的信
Read story = 閱讀故事
Read TV listing = 查看電視節目表
Rebind Controls = Rebind Controls
-Record JFK off HBO\n-Magic Bullet theory?\n-Lone gunman?\n-X-Files: Check w/ Sam = -把HBO的甘迺迪特輯錄下來\n-魔彈理論？\n-狙擊手？\n-X檔案：與小珊共賞
Red Right Hand\n\nSemi-Permanent Hair Dye = 紅之右手\n\n半永久染髮劑
Regional Track and Field Finals\nGirls 100-Meter Relay\nFirst Place\nJamie Blume, Carla Jones, Shawna Rossi, Kaitlin Greenbriar = 區域田徑決賽\n女子100公尺接力\n第一名\n潔米・布洛米、卡拉・瓊斯、肖那・羅西、凱特琳・葛林布萊爾
Regional Track and Field Finals\nGirls Long Jump Event\nKaitlin Greenbriar\nFirst Place = 區域田徑賽\n女子跳遠\n凱特琳・葛林布萊爾\n冠軍
Resolution: = 解析度:
Restore Defaults = 還原預設值
Resume = 繼續遊戲
Richard Greenbriar, Ph.D\n\nProfessor Laureate of English\nUniversity of Oregon, 1956 = 理查・葛林布萊爾博士\n\n獲英國語文博士殊榮\n1956年，奧瑞岡大學
Rick\n\8 o'clock\n\Friday = Rick\n\8 o'clock\n\Friday
Sam, Katie, Mom (Jan), and Dad (Terry) = 小珊, 凱蒂, 媽 (珍), 和爸爸(泰瑞)
Sam:\n\nStop leaving every damn light in the house on! You're as bad as your sister! = 小珊：\n\n不要把房子的燈通通打開！怎麼和你姐一樣講不聽！
Sam-\nStop leaving every damn light in the house on! You're as bad as your sister! = 小珊－\n不要把房子的燈通通打開！怎麼和你姐一樣講不聽！
Samantha\n\nS is for Special\nA is for Adorable\nM is for Merry\nA is for Affectionate\nN is for Nice\nT is for Thoughtful\nH is for Honest\nA is for Admirable = 小珊，珊曼莎(Samantha)\n\nS 就是與眾不同（Special）\nA就是清純可人（Adorable）\nM就是平安喜樂（Merry）\nA就是熱情如火（Affectionate）\nN就是很好相處（Nice）\nT就是設身處地（Thoughtful）\nH就是誠實無欺（Honest）\n最後的A就是令人欽佩（Admirable）
Sam's Darkroom\n\nDo not enter if red lights are on!!!!! = 小珊的暗房\n\n紅燈亮的時候別進來!!!!!
Sam's Journal - "Daniel" = 小珊的手札 - "丹尼爾"
Sam's Journal - "Dedication" = 小珊的手札 - "僅獻給妳"
Sam's Journal - "Getting Lonnie" = 小珊的手札 - "我不懂「妮」"
Sam's Journal - "I Can Sing" = 小珊的手札 - "我能唱歌"
Sam's Journal - "I Said Yes" = 小珊的手札 - "我願意"
Sam's Journal - "It's Different Now" = 小珊的手札 - "不同以往"
Sam's Journal - "Hanging Out With Girls" = 小珊的手札 - "姐妹淘出遊"
Sam's Journal - "Life Moves On" = 小珊的手札 - "總是要過生活"
Sam's Journal - "Ship Date" = 小珊的手札 - "奔走他鄉"
Sam's Journal - "The Nunnery" = 小珊的手札 - "剃度成尼"
Sam's Journal - "Adjusting to the Dark" = 小珊的手札 - "黑暗裡的美好事物"
Sam's Journal - "At the New House" = 小珊的手札 - "新居落成"
Sam's Journal - "Dealing With Roots" = 小珊的手札 - "三千煩惱絲"
Sam's Journal - "Best-Laid Plans" = 小珊的手札 - "錦囊妙計"
Sam's Journal - "Default Friends" = 小珊的手札 - "基本盤朋友"
Sam's Journal - "First Day of School" = 小珊的手札 - "新生到課"
Sam's Journal - "Big Gold Star" = 小珊的手札 - "非認識妳不可"
Sam's Journal - "Lie-to-Mom-and-Dad Situation" = 小珊的手札 - "欺瞞父母的狀況"
Sam's Journal - "There Was Nothing Wrong" = 小珊的手札 - "這沒有什麼嘛"
Sam's Journal - "Stick With The Group" = 小珊的手札 - "別落單"
Sam's Journal - "A Very Long Phase" = 小珊的手札 - "好一段過程"
Sam's Room = 小珊的房間
Save & Quit to Desktop = 存檔並返回桌面
Save & Quit to Menu = 存檔並返回選單
Save progress and quit to main menu? = 存檔並返回主選單？
Scrutinize = Scrutinize
Secondary = Secondary
SecondaryFont = SecondaryFont
Secret passage marked on map. Press <Map> to review = 地圖上已標示密道，按 <Map> 檢視
Sept. 15, 1994 = 1994年9月15日
Sept. 6, 1994 = 1994年9月6日
Sept. 13, 1994 = 1994年9月13日
Servant's\nQuarters = Servant's\nQuarters
Sewing\nRoom = 裁縫間
Shadow Distance = 陰影距離
Show All Resolutions = 顯示全部解析度
Show Training Messages = 顯示新手輔助訊息
Sitting\nRoom = 客廳
Slide door = 滑門
Sonic Youth\n\nThe Amps\n\nBikini Kill = 音速青春\n\nThe Amps\n\nBikini Kill
Sound = 音效
Sound Effects Volume = 音效音量
Sound Options = 音效設定
Stare = 盯著它
Start = 開始
Starting a new game will overwrite \nexisting game progress. \nAre you sure? = 另開新遊戲將會 \n覆蓋現有進度. \n確定要重來？
State of Emergency in Dallas cancels motorcade = 達拉斯的緊急狀況取消了車隊
Sticky Targeting = 目標鎖定
Stop playback = 停止播放
Stop record = 退帶
Storage = 儲藏室
Strong Pines\nA Couples' Counseling Retreat\n\nBOOKED: June 3-7, 1995 = 史壯松木林\n坐落哥倫比亞峽谷，夫妻最佳的婚姻諮商度假勝地\n\n已預約1995年6月3日到7日
Super Spitfire = 超級火焰
Swap Left/Right Sticks = 左右搖桿互換
Switch fan = 開關風扇
Switch to Gamepad = 以搖桿操控
Switch to Mouse and Keyboard = 以滑鼠和鍵盤操控
Take 1st combo scrap = 拾起左半片置物櫃密碼的殘片
Take 2nd combo scrap = 拾起右半片置物櫃密碼的殘片
Take attic key = 拾起閣樓鑰匙
Take housekey = 拾起家門鑰匙
Take key = 拾起鑰匙
Take little allen wrench = Take little allen wrench
Take your time. I'm glad to have it in good hands.\n\-Rick = 好好看吧。很高興可以借給有緣人。\n\-力克
Takelma County Forestry Service\nJanice Greenbriar\nSenior Conservationist = 特克馬郡林務局\n珍妮絲・葛林布萊爾\n資深保育員
Terrence L. Greenbriar\n\nThe Accidental Pariah = 泰倫斯・Ｌ・葛林布萊爾\n\n意外成公敵
Terrence L. Greenbriar\n\nThe Accidental Savior = 泰倫斯・Ｌ・葛林布萊爾\n\n意外成救星
Terry Age 12\nThanksgiving 1963 = 小泰12歲時\n1963年感恩節
Text = 文本
The Accidental Human\n\nby Terrence L. Greenbriar = 意外成凡人\n\n泰倫斯・Ｌ・葛林布萊爾　著
The Accidental Pariah\nTerrence L. Greenbriar\n\n\nAnother UNKNOWN DIMENSION LITERATURE Discovery = 意外成公敵\n泰倫斯・Ｌ・葛林布萊爾\n\n\n未知次元文學社再版
The Accidental Savior\nTerrence L. Greenbriar\n\n\nAnother UNKNOWN DIMENSION LITERATURE Discovery = 意外成救星\n泰倫斯・Ｌ・葛林布萊爾\n\n\n未知次元文學社再版
The Accidental Warrior\n\nTerrence L. Greenbriar\n\nDon't give up on this, honey! = 意外成勇士\n\n泰倫斯・Ｌ・葛林布萊爾\n\n親愛的，別放棄寫作！
The completed combination for the locker in Sam's room. = 小珊房間置物櫃的完整密碼。
The first half of the combination to Sam's locker. = 一部份小珊置物櫃的密碼。
The Great Goodfellow Riot of '95 = The Great Goodfellow Riot of '95
The Killing of JFK: A Theory\n\nYou've Seen the Movie\nDiscover the Truth = 誰殺了甘迺迪: 理論篇\n\n你看過電影了\n現在來揭發真相
The Miss-Fits = The Miss-Fits
The second half of the combo for Sam's locker. = 另一部份小珊置物櫃的密碼。
The Slits = The Slits
The tag says "attic." = 標簽上寫著「閣樓」
The tag says "Basement." = 標簽上寫著 「地下室」
The Wipers = The Wipers
There you go, Christmas Duck. = 原來是你啊，聖誕鴨。
There's nothing I don't hate right now. = 現在沒有什麼我不討厭的了。
These modifiers result in a non-standard experience.\n      Modifiers cannot be changed while in-game. = 這些修改器設定會玩家有不同的體驗\n      注意在過程中無法更動這部分的選項
This can open the heating vent covers on the first floor. = This can open the heating vent covers on the first floor.
This is my boarding pass back from my year in Europe. = 這是當年在歐洲的登機證。
to 2nd Floor = 往二樓
to Attic = 往閣樓
to Basement = 往地下室
to Downstairs = 往樓下
to Guestroom = 往客房
to Upstairs = 往樓上
to\nBasement = 往地下室
to\nUpstairs = 往樓上
Toggle = 放大
Turn faucet on = 開水龍頭
Turn faucet off = 關水龍頭
Turn lamp off = 關檯燈
Turn lamp on = 打開檯燈
Turn off lights = 關燈
Turn on lights = 開燈
Turn TV off = 關電視
Turn TV on = 開電視
TV Room = 視聽間
Twist sconce = Twist sconce
Ugh. = 屙...
United States Department of Agriculture\n\nUS National Forestry Manual\n\Northwest Region Prescribed Burn Procedures and Precautions = 美利堅合眾國農業局\n\n西北區焚林程序與注意事項指南\n\西北區焚林程序與注意事項指南
Unknown Dimension Literature\n\nKaz\nPublisher = 未知領域文學社\n\n凱茲\n出版人
Unlock = Unlock
UNLOCK ALL DOORS - Every door bigts unlocked.\nExplore the house, and the story, in any order. = 打開所有的門 - 所有門都打開了。\n隨心所欲的探索這間房子內的故事。
Unlock door = 打開門
Unlock from the inside = 從另一側打開門
Unlock locker = 打開置物櫃
Unlocked! = 打開了!
Up a Floor = 往上一層
Vent tool = Vent tool
View Backpack = 檢查背包
View Journals = 翻閱手札
View Map = 檢視地圖
Voice Volume = 語音音量
Vsync = 垂直同步
Walk Backwards = 往前走
Walk Forwards = 往後走
Walk Left = 往左走
Walk Right = 往右走
Walt Whitman\n\Leaves of Grass = 華特・惠特曼\n\草葉集
Watercolor Technique = 水彩技法
What if JFK wasn't JFK?? = 如果甘迺迪不是甘迺迪??
Why not disrupt motorcade minutes before LHO can fire? = 為何不在哈維開火前停止車隊？
Wildfire\n\nHe saved her from the raging flames...and then things really heated up! = 慾火燎原\n\n他在焚林大火中拯救了她，然後事情就開始火熱了起來！
World History = 世界歷史
X-Ray Spex = X-Ray Spex
Yes = 是
You Can Do Better = 你可以做得更好
Zoom = 放大
